0,1,2,1,0
1,3,3,3,1
1,3,3,3,1
1,3,3,3,1
0,1,3,1,0
0,1,5,1,0
0,1,4,1,0
