0,1,2,1,0
1,6,5,6,1
1,3,7,3,1
1,6,5,6,1
0,1,1,1,0
